W W W W W W W W W W W W W W W W
W - - - - - - - - - - - - - - W 
W - P - - - - - - - - - - - - W 
W - - - - - - - R - - - R - - W 
W - - - - D D D D D D - D - - W 
W - - - - D D D D G D - - - - W 
W - - - - D D D D D D - - - - W 
W - - - - D D R D D D - - - - W 
W - - - - D D D D D D - - - - W 
W - - - - - - - - - - - - - - W
W - - - - - - - - - - - G - - W
W - - - - - - - - - - - - - - W
W W W W W W W W W W W W W W W W