W W W W W W W W W W W W W W W W W W W W W W W W W
W W W W W W W W W W W W W W W W W W W W W W W W W
W R R R W W R W W R W R W R R R W W W W W W W W W
W R W W W R W R W R R R W R W W W W W W W W W W W
W R W R W R R G W R W R W R R R W W W W W W W W W
W R W R W R W R W R W R W G W W W W W W W W W W W
W R R G W R W R W R W R W R R R W W W W W W W W W
W W W W W W W W W W W W W W W W W W W W W W W W W
W W W W W W W W W R R R W R W R W G R R W R R W W
W W W W W W W W W R W R W R W R W R W W W R W R W
W W W W W W W W W R W R W R W R W R R R W R R W W
W W W W W W W W W R W R W R W R W R W W W R W R W
W W W W W W W W W G R R W W R W W R R R W R W R W
W W W W W W W W W W W W W W W W W W W W W W W W W
W W W W W W W W W W W W W W W W W W W W W W W W W