W W W W W W W W W W W W W W W W
W D D R D D D D D D D D D D D W 
W D G D D R D D R D G D D D D W 
W D D D D D D D D D D D D D D W 
W R D D D D D D D D D D D D D W 
W D D D D R D D D G R G D D R W 
W D R D D D D P D D D D D D D W 
W D D R D D D D D D D D D D D W 
W D D D D D D D D D G D R D D W 
W D G D R D R D D D R D D D D W
W D D R D D G D D D D D D R G W
W D D D D D D D D D D D D D D W
W W W W W W W W W W W W W W W W