W W W W W W W W W W W W W W W W
W D D D D D D D G D D R D D D W
W R D D D D D D D D D D R G D W
W G D D D D R R D D D D D R D W
W R D D P D D D D R D D D D R W
W D D D D D D D D R D D D R D W
W D D D D R D D D D G D R D D W
W D R D D G D R D D D R D D D W
W D D D D D D D D D R D R D G W
W D D D R D R D D D D D D R D W
W D R D D D D D D D D D D D D W
W D D D D D D R D D R G D D D W
W W W W W W W W W W W W W W W W