W W W W W W W W W W W W W W W W W W W W
W D D D D D D D D D D D R D D D D D D W
W R D D D W D D G W W W D D W D D D D W
W G D D W D R R W D D D D D D W D D D W
W D D D W D D D W R D D P D D D D D D W
W R W W D D W D D R D D D D D D D D D W
W D D D D R D W D D G D D D D W D D D W
W D R D D G D W D D D D D D W D D D R W
W D D D D D D D W D D D R W G D D D D W
W D D D R D R D D G D D W D D R R R D W
W D R D D D D D D D D W D D D D R D D W
W D R D D D D R D D R R D D D D D R D W
W R D D W D D D D D D D D R D R D D D W
W D D D W D D D R D D W D D D D R D D W
W D D D W D D D D D D W D R D D D D D W
W D G D W D D R G D D W D R D D D G D W
W W W W W W W W W W W W W W W W W W W W