W W W W W W W W W W W W W W W W
W D D D D D D R G W D D D D G W
W D D D R D G R D D W D D D D W
W D D R D R R D D D W D D D D W
W R D D D D D D D D D W D D D W
W D D R D D D D D R D D W R R W
W D D D R R D D R D G D D D D W
W D R D D W D D D D D D D P D W
W D R D D D W D D R D D D D D W
W D D G D R D W D G D D D R D W
W D D D D R D W D D D D D D D W
W D D D D D D G W D R D D G D W
W W W W W W W W W W W W W W W W