W W W W W W W W W W W W W W W W
W - - - - - - - - - - - - - - W 
W - P - - - - - - - - - - - - W 
W - - - - - - - - - - - - - - W 
W - - - - D D D D D D - - - - W 
W - - - - D D D D D D - - - - W 
W - - - - D D D D D D - - - - W 
W - - - - D D D D D D - - - - W 
W - - - - D D D D D D - - - - W 
W - - - - - - - - - - - - - - W
W - - - - - - - - - - - - - - W
W - - - - - - - - - - - - - - W
W W W W W W W W W W W W W W W W