W W W W W W W W W W W W W W W W
W - - - - - - - - - - - - - - W 
W - P - - - - - - - - - - - - W 
W - - - - - - - R - - - R - - W 
W - - - - D D D D D D - D - - W 
W - - - - D D D D G D - - - - W 
W - - - - D D D D D D - - - - W 
W - - - - D D R D D D - - - - W 
W - - - - D D D D D D - - D - W 
W - - - - - - - - - - - R D - W
W - - - - - - - - - - - D D - W
W - E - - - - - - - - - D D - W
W W W W W W W W W W W W W W W W